~~~~~~~~~~~~~
~...........~
~=======.===~
~..=...==...~
~..=.....=..~
~..=..=..=..~
~~~~~~~~~~~~~