~~~~~~~~~~~~~
~....=...=..~
~=======.===~
~..=...=.=..~
~..=.....=..~
~..=..=.....~
~~~~~~~~~~~~~